NO ./textures/hh.xpm
SO ./textures/gg.xpm
WE ./textures/21.xpm
EA ./textures/42.xpm
F 152,102,51
C 151,204,255
111111111111111111111111111111
1E0000000000000000000000000001
111111111111111111111111111111